aardvark (en) --> cerdo hormiguero (es)
aardwolf (en) --> protelo (es)
abyssinian (en) --> abisinio (es)
achrioptera manga (en) --> acrioptera manga (es)
addax (en) --> Addax (es)
adelie penguin (en) --> pinguino adelaida (es)
aesculapian snake (en) --> serpiente de esculapio (es)
affenpinscher (en) --> affenpinscher (es)
afghan hound (en) --> sabueso afgano (es)
african bullfrog (en) --> rana toro africana (es)
african bush elephant (en) --> elefante africano de sabana (es)
african civet (en) --> civeta africana (es)
african clawed frog (en) --> rana africana con garras (es)
african forest elephant (en) --> elefante africano del bosque (es)
african grey parrot (en) --> Loro gris africano (es)
african palm civet (en) --> civeta de palma africana (es)
african penguin (en) --> pingüino africano (es)
african tree toad (en) --> sapo de árbol africano (es)
african wild dog (en) --> perro salvaje africano (es)
agama lizard (en) --> lagarto agama (es)
aidi (en) --> aidi (es)
ainu (en) --> aino (es)
airedale terrier (en) --> airedale terrier (es)
airedoodle (en) --> garabato aireado (es)
akbash (en) --> akbash (es)
akita (en) --> akita (es)
akita shepherd (en) --> pastor akita (es)
alabai (en) --> alabai (es)
alaskan husky (en) --> husky de alaska (es)
alaskan klee kai (en) --> alaska klee kai (es)
alaskan malamute (en) --> Malamute de Alaska (es)
alaskan pollock (en) --> abadejo de alaska (es)
alaskan shepherd (en) --> pastor de alaska (es)
albacore tuna (en) --> el atún blanco (es)
albatross (en) --> albatros (es)
aldabra giant tortoise (en) --> tortuga gigante de aldabra (es)
alligator (en) --> caimán (es)
alligator gar (en) --> gar cocodrilo (es)
allosaurus (en) --> alosaurio (es)
alpaca (en) --> alpaca (es)
alpine dachsbracke (en) --> dachsbracke alpino (es)
alpine goat (en) --> cabra alpina (es)
alusky (en) --> alusky (es)
amargasaurus (en) --> amargasaurio (es)
amazon parrot (en) --> loro amazona (es)
amazon river dolphin (en) --> delfín del río amazonas (es)
pink dolphin (en) --> delfín rosado (es)
amazon tree boa (en) --> boa amazónica (es)
ambrosia beetle (en) --> escarabajo ambrosía (es)
american alsatian (en) --> alsaciano americano (es)
american bulldog (en) --> bulldog americano (es)
american cocker spaniel (en) --> cocker americano (es)
american cockroach (en) --> cucaracha americana (es)
american coonhound (en) --> coonhound americano (es)
american dog tick (en) --> garrapata del perro americano (es)
american eskimo dog (en) --> perro esquimal americano (es)
american foxhound (en) --> foxhound americano (es)
american hairless terrier (en) --> terrier americano sin pelo (es)
american leopard hound (en) --> sabueso leopardo americano (es)
american pit bull terrier (en) --> pit bull terrier americano (es)
american pygmy goat (en) --> cabra pigmea americana (es)
american robin (en) --> petirrojo americano (es)
american staffordshire terrier (en) --> American Staffordshire Terrier (es)
american toad (en) --> sapo americano (es)
american water spaniel (en) --> perro de aguas americano (es)
amethystine python (en) --> pitón amatista (es)
amur leopard (en) --> El Leopardo de Amur (es)
anaconda (en) --> anaconda (es)
anatolian shepherd dog (en) --> perro pastor de anatolia (es)
anchovies (en) --> anchoas (es)
angelfish (en) --> angelote (es)
anglerfish (en) --> rape (es)
angora ferret (en) --> hurón de angora (es)
angora goat (en) --> cabra de angora (es)
anole lizard (en) --> lagarto anolis (es)
anomalocaris (en) --> anomalocaris (es)
ant (en) --> hormiga (es)
antarctic scale worm (en) --> gusano de escama antártica (es)
anteater (en) --> oso hormiguero (es)
antelope (en) --> antílope (es)
ape (en) --> mono (es)
appenzeller dog (en) --> perro appenzeller (es)
apple head chihuahua (en) --> chihuahua cabeza de manzana (es)
apple moth (en) --> polilla de la manzana (es)
arabian cobra (en) --> cobra árabe (es)
arafura file snake (en) --> serpiente de archivo arafura (es)
arapaima (en) --> arapaima (es)
archaeopteryx (en) --> arqueoptérix (es)
archaeotherium (en) --> arqueoterio (es)
archelon turtle (en) --> tortuga archelon (es)
arctic fox (en) --> zorro ártico (es)
arctic hare (en) --> liebre ártica (es)
arctic wolf (en) --> Lobo ártico (es)
arctodus (en) --> arctodus (es)
arctotherium (en) --> arctoterio (es)
arizona bark scorpion (en) --> escorpión de corteza de arizona (es)
arizona black rattlesnake (en) --> serpiente de cascabel negra de arizona (es)
arizona coral snake (en) --> serpiente de coral de arizona (es)
armadillo (en) --> armadillo (es)
armadillo lizard (en) --> lagarto armadillo (es)
armyworm (en) --> gusano cogollero (es)
aruba rattlesnake (en) --> serpiente de cascabel (es)
asian arowana (en) --> Arowana asiático (es)
asian cockroach (en) --> cucaracha asiática (es)
asian elephant (en) --> elefante asiático (es)
asian giant hornet (en) --> avispón gigante asiático (es)
asian palm civet (en) --> civeta de palma asiática (es)
asian vine snake (en) --> serpiente de vid asiática (es)
asiatic black bear (en) --> oso negro asiático (es)
assassin bug (en) --> insecto asesino (es)
atlantic salmon (en) --> salmón atlántico (es)
atlas moth (en) --> polilla del atlas (es)
aurochs (en) --> uro (es)
aussiedoodle (en) --> aussiedoodle (es)
aussiedor (en) --> australiano (es)
australian bulldog (en) --> bulldog australiano (es)
australian cattle dog (en) --> perro australiano del ganado (es)
australian cockroach (en) --> cucaracha australiana (es)
australian flathead perch (en) --> perca de cabeza plana australiana (es)
australian gecko (en) --> geco australiano (es)
australian kelpie dog (en) --> perro kelpie australiano (es)
australian labradoodle (en) --> labradoodle australiano (es)
australian mist (en) --> niebla australiana (es)
australian retriever (en) --> perro perdiguero australiano (es)
australian shepherd (en) --> Pastor australiano (es)
australian terrier (en) --> terrier australiano (es)
australopithecus (en) --> australopiteco (es)
avocet (en) --> avoceta (es)
axolotl (en) --> ajolote (es)
aye aye (en) --> ey ey (es)
babirusa (en) --> babirusa (es)
baboon (en) --> babuino (es)
bactrian camel (en) --> camello bactriano (es)
badger (en) --> tejón (es)
baiji (en) --> Baiji (es)
baird’s rat snake (en) --> serpiente rata de Baird (es)
bald eagle (en) --> Águila calva (es)
baleen whale (en) --> ballena barbada (es)
balinese (en) --> balinés (es)
balkan lynx (en) --> lince balcánico (es)
ball python (en) --> pitón bola (es)
bamboo worms (en) --> gusanos de bambú (es)
banana ball python (en) --> pitón bola de plátano (es)
banana eel (en) --> anguila banana (es)
banana spider (en) --> araña de plátano (es)
banded krait (en) --> krait anillado (es)
banded palm civet (en) --> civeta de palma rayada (es)
banded water snake (en) --> serpiente de agua con bandas (es)
bandicoot (en) --> bandido (es)
banjo catfish (en) --> bagre banjo (es)
barb (en) --> lengüeta (es)
barbet (en) --> barbudo (es)
barn owl (en) --> lechuza (es)
barn swallow (en) --> trago de granero (es)
barnacle (en) --> percebe (es)
barracuda (en) --> barracuda (es)
barramundi fish (en) --> pez barramundi (es)
barred owl (en) --> búho barrado (es)
basenji dog (en) --> perro basenji (es)
basilisk lizard (en) --> lagarto basilisco (es)
basilosaurus (en) --> basilosaurio (es)
basking shark (en) --> tiburón peregrino (es)
bassador (en) --> bajista (es)
basset fauve de bretagne (en) --> basset fauve de bretaña (es)
basset hound (en) --> sabueso basset (es)
bassetoodle (en) --> Bassetoodle (es)
bat (en) --> murciélago (es)
batfish (en) --> pez murciélago (es)
bavarian mountain hound (en) --> Sabueso bávaro de montaña (es)
baya (en) --> bahía (es)
bea-tzu (en) --> bea-tzu (es)
beabull (en) --> beabull (es)
beagador (en) --> begador (es)
beagle (en) --> beagle (es)
beagle shepherd (en) --> pastor beagle (es)
beaglier (en) --> más rudo (es)
beago (en) --> beago (es)
bear (en) --> llevar (es)
bearded collie (en) --> collie barbudo (es)
bearded dragon (en) --> Dragon barbudo (es)
bearded vulture (en) --> quebrantahuesos (es)
beaski (en) --> Beaski (es)
beauceron (en) --> beauceron (es)
beauty rat snake (en) --> serpiente rata de belleza (es)
beaver (en) --> castor (es)
bed bugs (en) --> chinches (es)
bedlington terrier (en) --> terrier de bedlington (es)
bee (en) --> abeja (es)
beefalo (en) --> bufalo (es)
beetle (en) --> escarabajo (es)
belgian shepherd (en) --> pastor belga (es)
belgian tervuren (en) --> Tervuren belga (es)
beluga sturgeon (en) --> esturión beluga (es)
bengal tiger (en) --> Tigre de Bengala (es)
bergamasco (en) --> bergamasco (es)
berger picard (en) --> picard de berger (es)
bernedoodle (en) --> bernedoodle (es)
bernese mountain dog (en) --> Perro de montaña de Bernese (es)
bernese shepherd (en) --> pastor bernés (es)
betta fish (en) --> pez Betta (es)
siamese fighting fish (en) --> pez luchador siamés (es)
bichir (en) --> bichir (es)
bichon frise (en) --> bichón frisé (es)
bichpoo (en) --> bichpoo (es)
biewer terrier (en) --> terrier biewer (es)
bighorn sheep (en) --> borrego cimarrón (es)
bilby (en) --> bilby (es)
binturong (en) --> binturong (es)
bird (en) --> pájaro (es)
bird of paradise (en) --> AVE del Paraiso (es)
birman (en) --> birmano (es)
biscuit beetle (en) --> escarabajo de las galletas (es)
bison (en) --> bisonte (es)
black and tan coonhound (en) --> coonhound negro y fuego (es)
black mamba (en) --> Mamba negro (es)
black marlin (en) --> aguja negra (es)
black rat snake (en) --> serpiente rata negra (es)
black rhinoceros (en) --> rinoceronte negro (es)
black russian terrier (en) --> terrier ruso negro (es)
black wasp (en) --> avispa negra (es)
black widow spider (en) --> araña viuda negro (es)
black witch moth (en) --> polilla bruja negra (es)
black-capped chickadee (en) --> carbonero de cabeza negra (es)
black-footed ferret (en) --> hurón de patas negras (es)
black-headed python (en) --> pitón de cabeza negra (es)
blacknose shark (en) --> tiburón nariz negra (es)
blackpoll warbler (en) --> curruca negra (es)
blacktip reef shark (en) --> tiburón punta negra (es)
bladefin basslet (en) --> lubina de aleta de hoja (es)
blanket octopus (en) --> pulpo manta (es)
blind snake (en) --> serpiente ciega (es)
blister beetle (en) --> escarabajo ampolla (es)
blobfish (en) --> pez globo (es)
blood python (en) --> pitón de sangre (es)
bloodhound (en) --> sabueso (es)
blue belly lizard (en) --> lagarto de vientre azul (es)
blue catfish (en) --> bagre azul (es)
blue eyed pleco (en) --> pleco de ojos azules (es)
blue gray gnatcatcher (en) --> cazador de mosquitos gris azulado (es)
blue grosbeak (en) --> picogrueso azul (es)
blue iguana (en) --> iguana azul (es)
blue jay (en) --> arrendajo azul (es)
blue lacy dog (en) --> perro de encaje azul (es)
blue picardy spaniel (en) --> Spaniel de picardía azul (es)
blue racer (en) --> corredor azul (es)
blue shark (en) --> tiburón azul (es)
blue tit (en) --> alionín (es)
blue whale (en) --> ballena azul (es)
blue-ringed octopus (en) --> pulpo de anillos azules (es)
bluefin tuna (en) --> atún rojo (es)
bluegill (en) --> mojarra azul (es)
bluetick coonhound (en) --> Coonhound Bluetick (es)
boas (en) --> boas (es)
bobcat (en) --> gato montés (es)
bobolink (en) --> boboenlace (es)
boelen’s python (en) --> pitón de boelen (es)
boggle (en) --> sobresaltarse (es)
boglen terrier (en) --> terrier boglen (es)
boiga (en) --> boiga (es)
bolivian anaconda (en) --> anaconda boliviana (es)
bolognese dog (en) --> perro boloñesa (es)
bombay (en) --> Bombay (es)
bongo (en) --> bongó (es)
bonito fish (en) --> pescado bonito (es)
bonnethead shark (en) --> tiburón cabeza de bonete (es)
bonobo (en) --> bonobo (es)
booby (en) --> bobo (es)
boomslang (en) --> boomslang (es)
borador (en) --> borador (es)
border collie (en) --> collie de la frontera (es)
border terrier (en) --> terrier fronterizo (es)
bordoodle (en) --> bordillo (es)
borkie (en) --> borracho (es)
bornean orang-utan (en) --> orangután de Borneo (es)
borneo elephant (en) --> elefante de Borneo (es)
boston terrier (en) --> terrier de boston (es)
bottlenose dolphin (en) --> delfín nariz de botella (es)
bouvier des flandres (en) --> bouvier des flandres (es)
bowfin (en) --> aleta de proa (es)
bowhead whale (en) --> ballena (es)
box tree moth (en) --> polilla del boj (es)
box turtle (en) --> tortuga de caja (es)
boxador (en) --> boxador (es)
boxer dog (en) --> perro boxeador (es)
boxerdoodle (en) --> boxeador (es)
boxfish (en) --> cofre (es)
boxsky (en) --> cielo de caja (es)
boxweiler (en) --> boxweiler (es)
boykin spaniel (en) --> perro de aguas boykin (es)
brachiosaurus (en) --> braquiosaurio (es)
brahminy blindsnake (en) --> serpiente ciega brahminy (es)
brazilian terrier (en) --> terrier brasileño (es)
bredl’s python (en) --> pitón de bredl (es)
british timber (en) --> madera británica (es)
brittany (en) --> Bretaña (es)
brontosaurus (en) --> brontosaurio (es)
bronze whaler shark (en) --> tiburón ballenero de bronce (es)
brookesia micra (en) --> brookesia micra (es)
brown bear (en) --> oso café (es)
brown dog tick (en) --> garrapata marrón del perro (es)
brown hyena (en) --> hiena marrón (es)
brown snake (en) --> serpiente marrón (es)
brown water snake (en) --> serpiente de agua marrón (es)
brown-banded cockroach (en) --> cucaracha de bandas marrones (es)
brug (en) --> brujas (es)
brussels griffon (en) --> grifón de bruselas (es)
budgerigar (en) --> periquito (es)
buffalo (en) --> búfalo (es)
bull shark (en) --> tiburón toro (es)
bull terrier (en) --> Bull terrier (es)
bull trout (en) --> trucha toro (es)
bulldog (en) --> buldog (es)
bullfrog (en) --> rana mugidora (es)
bullmastiff (en) --> bullmastiff (es)
bullsnake (en) --> serpiente toro (es)
bumblebee (en) --> abejorro (es)
burmese (en) --> birmano (es)
burmese python (en) --> pitón birmana (es)
burrowing frog (en) --> rana excavadora (es)
burrowing owl (en) --> lechuza de madriguera (es)
bush baby (en) --> lemúrido (es)
bush viper (en) --> víbora de arbusto (es)
bushmaster snake (en) --> serpiente bushmaster (es)
butterfly (en) --> mariposa (es)
butterfly fish (en) --> pez mariposa (es)
cabbage moth (en) --> polilla de la col (es)
cactus moth (en) --> polilla del cacto (es)
cactus mouse (en) --> ratón de cactus (es)
caecilian (en) --> ceciliano (es)
caiman (en) --> caimán (es)
caiman lizard (en) --> lagarto caimán (es)
cairn terrier (en) --> terrier de mojón (es)
california kingsnake (en) --> serpiente rey de california (es)
camel (en) --> camello (es)
camel cricket (en) --> grillo camello (es)
camel spider (en) --> araña camello (es)
canaan dog (en) --> perro canaan (es)
canada lynx (en) --> lince de canadá (es)
canada warbler (en) --> curruca canadá (es)
canadian eskimo dog (en) --> perro esquimal canadiense (es)
canadian horse (en) --> caballo canadiense (es)
cane corso (en) --> corso de caña (es)
cantil (en) --> voladizo (es)
cape lion (en) --> león del cabo (es)
capybara (en) --> carpincho (es)
caracal (en) --> lince (es)
caribbean reef shark (en) --> tiburón de arrecife del caribe (es)
caribou (en) --> caribú (es)
carolina dog (en) --> perro carolina (es)
carolina parakeet (en) --> periquito carolina (es)
carp (en) --> carpa (es)
carpenter ant (en) --> hormiga carpintera (es)
carpet python (en) --> pitón alfombra (es)
carpet viper (en) --> víbora de alfombra (es)
cascabel (en) --> cascabel (es)
cashmere goat (en) --> cabra de cachemira (es)
cassowary (en) --> casuario (es)
cat (en) --> gato (es)
cat snake (en) --> serpiente gato (es)
cat-eyed snake (en) --> serpiente de ojos de gato (es)
catahoula leopard (en) --> leopardo catahoula (es)
catalan sheepdog (en) --> perro pastor catalán (es)
caterpillar (en) --> oruga (es)
catfish (en) --> bagre (es)
cava tzu (en) --> cava tzu (es)
cavador (en) --> caballero (es)
cavalier king charles spaniel (en) --> cavalier king charles spaniel (es)
cavapoo (en) --> cavapoo (es)
cave bear (en) --> oso de las cavernas (es)
cave lion (en) --> león de las cavernas (es)
cecropia moth (en) --> polilla cecropia (es)
centipede (en) --> ciempiés (es)
central ranges taipan (en) --> rangos centrales taipán (es)
ceratosaurus (en) --> ceratosaurio (es)
cesky fousek (en) --> cesky fousek (es)
cesky terrier (en) --> terrier cesky (es)
chameleon (en) --> camaleón (es)
chamois (en) --> gamuza (es)
chartreux (en) --> chartreux (es)
cheagle (en) --> cheagle (es)
checkered garter snake (en) --> serpiente de liga a cuadros (es)
cheetah (en) --> leopardo (es)
chesapeake bay retriever (en) --> perro perdiguero de bahía de chesapeake (es)
chickadee (en) --> paro (es)
chicken (en) --> pollo (es)
chicken snake (en) --> serpiente de pollo (es)
chihuahua (en) --> chihuahua (es)
children’s python (en) --> pitón de los niños (es)
chimaera (en) --> quimera (es)
chimpanzee (en) --> chimpancé (es)
chinchilla (en) --> chinchilla (es)
chinese alligator (en) --> cocodrilo chino (es)
chinese cobra (en) --> cobra china (es)
chinese crested dog (en) --> perro crestado chino (es)
chinese geese (en) --> gansos chinos (es)
chinese paddlefish (en) --> pez espátula chino (es)
chinese shar-pei (en) --> shar-pei chino (es)
chinook (en) --> Chinook (es)
chinook salmon (en) --> salmón chinook (es)
chinstrap penguin (en) --> pinguino barbijo (es)
chipmunk (en) --> ardilla listada (es)
chipoo (en) --> chipoo (es)
chipping sparrow (en) --> gorrión astillado (es)
chiweenie (en) --> Chiweenie (es)
chorkie (en) --> chorlito (es)
chow chow (en) --> chow chow (es)
chow shepherd (en) --> pastor chow (es)
christmas island red crab (en) --> cangrejo rojo de la isla de navidad (es)
cicada (en) --> cigarra (es)
cichlid (en) --> cíclido (es)
cinereous vulture (en) --> buitre negro (es)
cinnamon ferret (en) --> hurón canela (es)
clouded leopard (en) --> leopardo longibando (es)
clownfish (en) --> pez payaso (es)
clumber spaniel (en) --> perro de aguas (es)
coachwhip snake (en) --> serpiente látigo (es)
coastal carpet python (en) --> pitón alfombra costera (es)
coastal taipan (en) --> taipán costero (es)
coati (en) --> coatí (es)
cobia fish (en) --> pez cobia (es)
cobras (en) --> cobras (es)
cockalier (en) --> cockalero (es)
cockapoo (en) --> cacatúa (es)
cockatiel (en) --> cacatúa (es)
cockatoo (en) --> cacatúa (es)
cocker spaniel (en) --> Cocker (es)
cockroach (en) --> cucaracha (es)
codfish (en) --> bacalao (es)
codling moth (en) --> polilla de la manzana (es)
coelacanth (en) --> celacanto (es)
collared peccary (en) --> pecarí de collar (es)
collett’s snake (en) --> la serpiente de collet (es)
collie (en) --> collie (es)
colossal squid (en) --> calamar colosal (es)
comet moth (en) --> polilla cometa (es)
common buzzard (en) --> ratonero común (es)
common european adder (en) --> sumador común europeo (es)
common frog (en) --> rana común (es)
common furniture beetle (en) --> escarabajo común de los muebles (es)
common house spider (en) --> araña común de la casa (es)
common loon (en) --> colimbo común (es)
common raven (en) --> cuervo común (es)
common toad (en) --> sapo común (es)
compsognathus (en) --> compsognato (es)
conger eel (en) --> congrio (es)
congo snake (en) --> serpiente del congo (es)
cookiecutter shark (en) --> tiburón cortador de galletas (es)
cooper’s hawk (en) --> halcón de cooper (es)
copperhead (en) --> cabeza de cobre (es)
coral (en) --> coral (es)
coral snake (en) --> serpiente de coral (es)
corgidor (en) --> corgidor (es)
corgipoo (en) --> corgipoo (es)
corkie (en) --> corcho (es)
corman shepherd (en) --> pastor corman (es)
corn rex cat (en) --> gato rex de maíz (es)
cornish rex (en) --> rex de Cornualles (es)
corn snake (en) --> serpiente de maíz (es)
coton de tulear (en) --> algodón de tulear (es)
cotton-top tamarin (en) --> tití cabeciblanco (es)
cottonmouth (en) --> boca de algodón (es)
cougar (en) --> Puma (es)
cow (en) --> vaca (es)
coyote (en) --> coyote (es)
crab (en) --> cangrejo (es)
crab spider (en) --> araña cangrejo (es)
crab-eating macaque (en) --> macaco cangrejero (es)
crabeater seal (en) --> foca cangrejera (es)
crane (en) --> grua (es)
crappie fish (en) --> pez mojarra (es)
crested gecko (en) --> geco crestado (es)
crested penguin (en) --> pinguino con cresta (es)
cricket (en) --> Grillo (es)
crocodile (en) --> cocodrilo (es)
cross fox (en) --> zorro cruzado (es)
cross river gorilla (en) --> gorila de río cruzado (es)
crow (en) --> cuervo (es)
crucian carp (en) --> carpa cruciana (es)
cuban boa (en) --> boa cubana (es)
cuban cockroach (en) --> cucaracha cubana (es)
cuckoo (en) --> cuco (es)
curly coated retriever (en) --> perro perdiguero de pelo rizado (es)
cuscus (en) --> cuscús (es)
cuttlefish (en) --> calamar (es)
czechoslovakian wolfdog (en) --> perro lobo checoslovaco (es)
dachsador (en) --> dachsador (es)
dachshund (en) --> perro tejonero (es)
daeodon (en) --> daeodon (es)
dalmadoodle (en) --> dalmadoodle (es)
dalmador (en) --> dalmador (es)
dalmatian (en) --> dálmata (es)
danios (en) --> danio (es)
dapple dachshund (en) --> perro salchicha moteado (es)
dark-eyed junco (en) --> junco de ojos oscuros (es)
darwin’s fox (en) --> zorro de darwin (es)
darwin’s frog (en) --> la rana de darwin (es)
death adder (en) --> víbora de la muerte (es)
death’s head cockroach (en) --> cucaracha cabeza de muerte (es)
deathwatch beetle (en) --> escarabajo de la muerte (es)
deer (en) --> ciervo (es)
deer head chihuahua (en) --> cabeza de venado chihuahua (es)
deer tick (en) --> garrapata de venado (es)
desert kingsnake (en) --> serpiente rey del desierto (es)
desert locust (en) --> langosta del desierto (es)
desert rain frog (en) --> rana de lluvia del desierto (es)
desert tortoise (en) --> tortuga del desierto (es)
deutsche bracke (en) --> freno alemán (es)
devils coach horse beetle (en) --> diablos entrenador caballo escarabajo (es)
devon rex (en) --> devon rex (es)
dhole (en) --> dhole (es)
diamond python (en) --> pitón de diamante (es)
diamondback moth (en) --> polilla de espalda de diamante (es)
dik-dik (en) --> dik-dik (es)
dingo (en) --> dingo (es)
diplodocus (en) --> diplodoco (es)
dire wolf (en) --> lobo terrible (es)
discus (en) --> disco (es)
doberman pinscher (en) --> dóberman pinscher (es)
dodo (en) --> vejestorio (es)
dog (en) --> perro (es)
dog tick (en) --> garrapata de perro (es)
dogo argentino (en) --> dogo argentino (es)
dogue de bordeaux (en) --> dogo de burdeos (es)
dolphin (en) --> delfín (es)
donkey (en) --> Burro (es)
dorgi (en) --> dorgi (es)
dorkie (en) --> tonto (es)
dormouse (en) --> lirón (es)
double doodle (en) --> garabato doble (es)
douc (en) --> douc (es)
doxiepoo (en) --> doxiepoo (es)
doxle (en) --> doxle (es)
draco volans lizard (en) --> lagarto draco volans (es)
dragonfish (en) --> pez dragón (es)
dragonfly (en) --> libélula (es)
drever (en) --> drever (es)
drum fish (en) --> pez tambor (es)
dubia cockroach (en) --> cucaracha dubia (es)
duck (en) --> pato (es)
dugong (en) --> dugongo (es)
dumeril’s boa (en) --> boa de dumeril (es)
dung beetle (en) --> escarabajo pelotero (es)
dunker (en) --> mojar (es)
dunnock (en) --> acentor común (es)
dusky dolphin (en) --> delfín oscuro (es)
dusky shark (en) --> tiburon oscuro (es)
dwarf boa (en) --> boa enana (es)
dwarf crocodile (en) --> cocodrilo enano (es)
dwarf hamster (en) --> hámster enano (es)
eagle (en) --> águila (es)
earthworm (en) --> lombriz (es)
earwig (en) --> tijereta (es)
eastern barred bandicoot (en) --> bandicut barrado del este (es)
eastern bluebird (en) --> pájaro azul del este (es)
eastern brown snake (en) --> serpiente marrón oriental (es)
eastern chipmunk (en) --> ardilla listada oriental (es)
eastern coral snake (en) --> serpiente de coral oriental (es)
eastern diamondback rattlesnake (en) --> serpiente de cascabel de espalda de diamante oriental (es)
eastern fence lizard (en) --> lagartija de cerca oriental (es)
eastern glass lizard (en) --> lagarto de cristal oriental (es)
eastern gorilla (en) --> gorila oriental (es)
eastern gray squirrel (en) --> ardilla gris oriental (es)
eastern green mamba (en) --> mamba verde oriental (es)
eastern indigo snake (en) --> serpiente índigo oriental (es)
eastern lowland gorilla (en) --> gorila oriental de tierras bajas (es)
eastern phoebe (en) --> Phoebe oriental (es)
eastern racer (en) --> corredor del este (es)
eastern rat snake (en) --> serpiente rata oriental (es)
eastern woodrat (en) --> rata de bosque oriental (es)
echidna (en) --> equidna (es)
eclectus parrot (en) --> loro eclectus (es)
edible frog (en) --> rana comestible (es)
eel (en) --> Anguila (es)
egyptian cobra (en) --> cobra egipcia (es)
egyptian goose (en) --> ganso egipcio (es)
egyptian mau (en) --> mau egipcio (es)
eland (en) --> elando (es)
elasmosaurus (en) --> elasmosaurio (es)
elasmotherium (en) --> elastomio (es)
electric catfish (en) --> bagre eléctrico (es)
electric eel (en) --> Anguila electrica (es)
elegant tern (en) --> charrán elegante (es)
elephant (en) --> elefante (es)
elephant seal (en) --> elefante marino (es)
elephant shrew (en) --> musaraña elefante (es)
elk (en) --> alce (es)
emerald tree monitor (en) --> monitor de árbol esmeralda (es)
emperor penguin (en) --> pingüino emperador (es)
emperor tamarin (en) --> tití emperador (es)
emu (en) --> emú (es)
english bulldog (en) --> Bulldog inglés (es)
english cocker spaniel (en) --> cocker spaniel ingles (es)
english cream golden retriever (en) --> golden retriever inglés crema (es)
english foxhound (en) --> sabueso ingles (es)
english pointer (en) --> puntero inglés (es)
english setter (en) --> setter ingles (es)
english shepherd (en) --> pastor ingles (es)
english springer spaniel (en) --> springer spaniel inglés (es)
entlebucher mountain dog (en) --> perro de montaña entlebucher (es)
epagneul pont audemer (en) --> epagneul puente audemer (es)
equatorial spitting cobra (en) --> cobra escupidora ecuatorial (es)
ermine (en) --> armiño (es)
escolar (en) --> escolares (es)
eskimo dog (en) --> perro esquimal (es)
eskipoo (en) --> esquipoo (es)
estrela mountain dog (en) --> perro de montaña estrella (es)
eurasian beaver (en) --> castor euroasiático (es)
eurasian jay (en) --> arrendajo euroasiático (es)
eurasian lynx (en) --> lince euroasiático (es)
eurasian nuthatch (en) --> trepador azul (es)
eurasian wolf (en) --> lobo euroasiático (es)
european bee-eater (en) --> abejaruco europeo (es)
european corn borer (en) --> barrenador europeo del maíz (es)
european polecat (en) --> turón europeo (es)
european robin (en) --> petirrojo europeo (es)
european wildcat (en) --> gato montés europeo (es)
evening bat (en) --> murciélago vespertino (es)
eyelash viper (en) --> víbora de pestañas (es)
falcon (en) --> halcón (es)
fallow deer (en) --> gamos (es)
false cobra (en) --> cobra falsa (es)
false coral snake (en) --> serpiente de coral falsa (es)
false killer whale (en) --> ballena asesina falsa (es)
false water cobra (en) --> cobra de agua falsa (es)
false widow spider (en) --> araña viuda falsa (es)
fangtooth (en) --> diente de colmillo (es)
feist (en) --> festejar (es)
fennec fox (en) --> zorro fennec (es)
fer-de-lance snake (en) --> serpiente fer-de-lance (es)
ferret (en) --> hurón (es)
ferruginous hawk (en) --> halcón real (es)
fiddler crab (en) --> cangrejo violinista (es)
field spaniel (en) --> perro de aguas de campo (es)
fierce snake (en) --> serpiente feroz (es)
fila brasileiro (en) --> fila brasilero (es)
fin whale (en) --> aleta de ballena (es)
finnish spitz (en) --> perro de Pomerania finlandés (es)
fire eel (en) --> anguila de fuego (es)
fire salamander (en) --> salamandra de fuego (es)
fire-bellied toad (en) --> sapo vientre de fuego (es)
firefly (en) --> luciérnaga (es)
fish (en) --> pez (es)
fisher cat (en) --> gato pescador (es)
fishing cat (en) --> gato pescador (es)
flamingo (en) --> flamenco (es)
flat-coated retriever (en) --> perro perdiguero de pelo plano (es)
flea (en) --> pulga (es)
florida gar (en) --> gar de florida (es)
florida panther (en) --> pantera florida (es)
florida woods cockroach (en) --> cucaracha de los bosques de florida (es)
flounder (en) --> platija (es)
flowerhorn fish (en) --> pez cuerno de flor (es)
fluke fish (en) --> pez trematodo (es)
summer flounder (en) --> lenguado de verano (es)
fly (en) --> volar (es)
flying fish (en) --> pez volador (es)
flying lemur (en) --> lémur volador (es)
flying snake (en) --> serpiente voladora (es)
flying squirrel (en) --> ardilla voladora (es)
football fish (en) --> pez futbol (es)
forest cobra (en) --> cobra del bosque (es)
formosan mountain dog (en) --> perro de montaña formosano (es)
fossa (en) --> fosa (es)
fox (en) --> zorro (es)
fox snakes (en) --> serpientes zorro (es)
fox squirrel (en) --> ardilla zorro (es)
fox terrier (en) --> foxterrier (es)
french bulldog (en) --> Bulldog francés (es)
frenchton (en) --> frenchton (es)
frengle (en) --> frenético (es)
freshwater crocodile (en) --> cocodrilo de agua dulce (es)
freshwater eel (en) --> anguila de agua dulce (es)
freshwater jellyfish (en) --> medusas de agua dulce (es)
frigatebird (en) --> Pájaro de fragata (es)
frilled lizard (en) --> lagarto con volantes (es)
frilled shark (en) --> tiburón con volantes (es)
frog (en) --> rana (es)
frogfish (en) --> pez sapo (es)
fruit bat (en) --> murciélago de la fruta (es)
fruit fly (en) --> mosca de la fruta (es)
fur seal (en) --> piel de foca (es)
gaboon viper (en) --> víbora de Gabón (es)
galapagos penguin (en) --> pingüino de galápagos (es)
galapagos shark (en) --> tiburón galápagos (es)
galapagos tortoise (en) --> tortuga galápagos (es)
gar (en) --> gar (es)
garden eel (en) --> anguila de jardín (es)
gargoyle gecko (en) --> gecko gárgola (es)
garter snake (en) --> serpiente de liga (es)
gazelle (en) --> gacela (es)
gecko (en) --> geco (es)
genet (en) --> gineta (es)
gentoo penguin (en) --> pingüino papúa (es)
geoffroys tamarin (en) --> tití de geoffroy (es)
gerberian shepsky (en) --> shepsky gerberiano (es)
gerbil (en) --> jerbo (es)
german cockroach (en) --> cucaracha alemana (es)
german pinscher (en) --> pinscher alemán (es)
german shepherd guide (en) --> guia pastor aleman (es)
german sheppit (en) --> pastor alemán (es)
german sheprador (en) --> pastor alemán (es)
german shorthaired pointer (en) --> braco alemán de pelo corto (es)
german spitz (en) --> perro de Pomerania aleman (es)
gharial (en) --> gavial (es)
ghost catfish (en) --> bagre fantasma (es)
ghost crab (en) --> cangrejo fantasma (es)
giant african land snail (en) --> caracol gigante africano (es)
giant armadillo (en) --> armadillo gigante (es)
giant clam (en) --> Almeja gigante (es)
giant leopard moth (en) --> polilla leopardo gigante (es)
giant panda bear (en) --> oso panda gigante (es)
giant salamander (en) --> salamandra gigante (es)
giant schnauzer (en) --> schnauzer gigante (es)
giant schnoodle (en) --> schnoodle gigante (es)
gibbon (en) --> gibón (es)
gila monster (en) --> monstruo Gila (es)
giraffe (en) --> jirafa (es)
glass frog (en) --> rana de cristal (es)
glass lizard (en) --> lagarto de cristal (es)
glechon (en) --> glechon (es)
glen of imaal terrier (en) --> cañada de imaal terrier (es)
glow worm (en) --> luciérnaga (es)
gnat (en) --> mosquito (es)
goat (en) --> cabra (es)
goberian (en) --> goberiano (es)
goblin shark (en) --> tiburon duende (es)
goldador (en) --> dorador (es)
golden dox (en) --> dox dorado (es)
golden lancehead (en) --> punta de lanza dorada (es)
golden lion tamarin (en) --> tití león dorado (es)
golden masked owl (en) --> búho enmascarado dorado (es)
golden newfie (en) --> novato dorado (es)
golden oriole (en) --> oropéndola (es)
golden pyrenees (en) --> pirineo dorado (es)
golden retriever (en) --> perro perdiguero de oro (es)
golden saint (en) --> santo dorado (es)
golden shepherd (en) --> pastor dorado (es)
golden-crowned flying fox (en) --> zorro volador de corona dorada (es)
goldendoodle (en) --> Doodle dorado (es)
goldfish (en) --> pez de colores (es)
goliath frog (en) --> rana goliat (es)
goliath tigerfish (en) --> pez tigre goliat (es)
gomphotherium (en) --> gonfoterio (es)
goonch catfish (en) --> bagre gonch (es)
goose (en) --> ganso (es)
gopher (en) --> ardilla de tierra (es)
gopher snake (en) --> serpiente de tierra (es)
gopher tortoise (en) --> tortuga terrestre (es)
gordon setter (en) --> setter gordon (es)
gorilla (en) --> gorila (es)
goshawk (en) --> azor (es)
gouldian finch (en) --> pinzón de gould (es)
grass carp (en) --> la carpa herbívora (es)
grass snake (en) --> serpiente de hierba (es)
grasshopper (en) --> saltamontes (es)
grasshopper mouse (en) --> ratón saltamontes (es)
gray fox (en) --> zorro gris (es)
gray tree frog (en) --> rana de árbol gris (es)
great blue heron (en) --> gran garza azul (es)
great crested flycatcher (en) --> gran papamoscas crestado (es)
great dane (en) --> Gran Danés (es)
great danoodle (en) --> gran danoodle (es)
great egret (en) --> gran garceta (es)
great hammerhead shark (en) --> gran tiburón martillo (es)
great plains rat snake (en) --> serpiente rata de las grandes llanuras (es)
great pyrenees (en) --> grandes pirineos (es)
great white shark (en) --> gran tiburón blanco (es)
greater swiss mountain dog (en) --> gran perro de montaña suizo (es)
green anaconda (en) --> anaconda verde (es)
green anole (en) --> anolis verde (es)
green bee-eater (en) --> abejaruco verde (es)
green frog (en) --> rana verde (es)
green heron (en) --> garza verde (es)
green mamba (en) --> mamba verde (es)
green rat snake (en) --> serpiente rata verde (es)
green snake (en) --> serpiente verde (es)
green tree frog (en) --> rana de árbol verde (es)
green tree python (en) --> pitón de árbol verde (es)
greenland dog (en) --> perro de Groenlandia (es)
greenland shark (en) --> tiburón de Groenlandia (es)
grey heron (en) --> garza gris (es)
grey mouse lemur (en) --> lémur ratón gris (es)
grey reef shark (en) --> tiburón gris de arrecife (es)
grey seal (en) --> foca gris (es)
greyhound (en) --> galgo (es)
griffon vulture (en) --> buitre leonado (es)
griffonshire (en) --> condado de griffon (es)
grizzly bear (en) --> oso grizzly (es)
groenendael (en) --> Groenendael (es)
ground snake (en) --> serpiente de tierra (es)
groundhog (en) --> marmota (es)
woodchuck (en) --> marmota de América (es)
grouper (en) --> agrupador (es)
grouse (en) --> queja (es)
guinea fowl (en) --> gallina de Guinea (es)
guinea pig (en) --> conejillo de indias (es)
guppy (en) --> guppy (es)
habu snake (en) --> serpiente habu (es)
haddock (en) --> eglefino (es)
hagfish (en) --> pez bruja (es)
halibut (en) --> Hipogloso (es)
hammerhead shark (en) --> Tiburon martillo (es)
hamster (en) --> hámster (es)
harbor seal (en) --> foca de puerto (es)
hardhead catfish (en) --> bagre cabeza dura (es)
hare (en) --> liebre (es)
harlequin snake (en) --> serpiente arlequín (es)
harp seal (en) --> foca arpa (es)
harpy eagle (en) --> Águila arpía (es)
harrier (en) --> aguilucho (es)
harris hawk (en) --> halcón harris (es)
havanese (en) --> bichón habanero (es)
havapoo (en) --> havapoo (es)
havashire (en) --> havashire (es)
hawaiian crow (en) --> cuervo hawaiano (es)
hawaiian goose (en) --> ganso hawaiano (es)
hawaiian monk seal (en) --> foca monje hawaiana (es)
hawk moth caterpillar (en) --> oruga de la polilla halcón (es)
hedgehog (en) --> erizo (es)
hellbender (en) --> juerguista (es)
hercules beetle (en) --> escarabajo hércules (es)
hercules moth (en) --> polilla hércules (es)
hermit crab (en) --> cangrejo ermitaño (es)
heron (en) --> garza (es)
herring (en) --> arenque (es)
highland cattle (en) --> ganado de las tierras altas (es)
himalayan (en) --> Himalaya (es)
hippopotamus (en) --> hipopótamo (es)
hoary bat (en) --> murciélago canoso (es)
hognose snake (en) --> serpiente nariz de cerdo (es)
hokkaido (en) --> hokkaidō (es)
honduran white bat (en) --> murciélago blanco hondureño (es)
honey badger (en) --> tejón de miel (es)
honey bee (en) --> miel de abeja (es)
honey buzzard (en) --> halcón de miel (es)
hooded oriole (en) --> oropéndola encapuchada (es)
hooded seal (en) --> sello encapuchado (es)
hook-nosed sea snake (en) --> serpiente marina de nariz ganchuda (es)
hoopoe (en) --> abubilla (es)
horgi (en) --> Horgi (es)
horn shark (en) --> tiburon cuerno (es)
hornbill (en) --> cálao (es)
horned adder (en) --> víbora cornuda (es)
horned frog (en) --> rana cornuda (es)
horned lizard (en) --> lagarto cornudo (es)
horned viper (en) --> víbora cornuda (es)
horse (en) --> caballo (es)
horsefly (en) --> tábano (es)
horseshoe crab (en) --> cangrejo de herradura (es)
house finch (en) --> pinzón doméstico (es)
house sparrow (en) --> gorrión (es)
house wren (en) --> reyezuelo (es)
housefly (en) --> mosca doméstica (es)
howler monkey (en) --> mono aullador (es)
human (en) --> humano (es)
humboldt penguin (en) --> pinguino de humboldt (es)
humboldt squid (en) --> calamar humboldt (es)
hummingbird (en) --> colibrí (es)
hummingbird hawk-moth (en) --> colibrí halcón-polilla (es)
humpback whale (en) --> ballena jorobada (es)
huntaway (en) --> cazar (es)
huntsman spider (en) --> araña cazadora (es)
huskador (en) --> descascarillador (es)
huskita (en) --> huskita (es)
husky (en) --> fornido (es)
husky jack (en) --> gato husky (es)
huskydoodle (en) --> garabato husky (es)
hyaenodon (en) --> hyaenodon (es)
hyena (en) --> hiena (es)
ibex (en) --> cabra montés (es)
ibis (en) --> ibis (es)
ibizan hound (en) --> sabueso ibicenco (es)
icelandic sheepdog (en) --> perro pastor islandés (es)
ichthyosaurus (en) --> ictiosauro (es)
iguana (en) --> iguana (es)
immortal jellyfish (en) --> medusa inmortal (es)
impala (en) --> impala (es)
imperial moth (en) --> polilla imperial (es)
indian cobra (en) --> cobra india (es)
indian elephant (en) --> elefante indio (es)
indian giant squirrel (en) --> ardilla gigante india (es)
indian palm squirrel (en) --> ardilla de palma india (es)
indian rhinoceros (en) --> rinoceronte indio (es)
indian star tortoise (en) --> tortuga estrella india (es)
indianmeal moth (en) --> polilla de la harina india (es)
indigo snake (en) --> serpiente índigo (es)
indochinese tiger (en) --> tigre de indochina (es)
indri (en) --> indri (es)
inland taipan (en) --> Taipan interior (es)
insect (en) --> insecto (es)
insects (en) --> insectos (es)
irish doodle (en) --> garabato irlandés (es)
irish setter (en) --> setter irlandés (es)
irish terrier (en) --> terrier irlandés (es)
irish water spaniel (en) --> perro de aguas irlandés (es)
irish wolfhound (en) --> perro lobo irlandés (es)
italian greyhound (en) --> galgo italiano (es)
ivory-billed woodpecker (en) --> pájaro carpintero de pico de marfil (es)
jacana (en) --> jacana (es)
jack russell (en) --> jack russell (es)
jackabee (en) --> jackabee (es)
jackal (en) --> chacal (es)
jackdaw (en) --> grajo (es)
jackrabbit (en) --> liebre (es)
jackson’s chameleon (en) --> camaleon de jackson (es)
jaguar (en) --> jaguar (es)
jaguarundi cat (en) --> gato jaguarundi (es)
jamaican boa (en) --> boa jamaicana (es)
japanese beetle (en) --> escarabajo japonés (es)
japanese chin (en) --> barbilla japonesa (es)
japanese macaque (en) --> macaco japonés (es)
japanese rat snake (en) --> serpiente rata japonesa (es)
japanese spitz (en) --> perro de Pomerania japones (es)
japanese squirrel (en) --> ardilla japonesa (es)
japanese terrier (en) --> terrier japonés (es)
javan rhinoceros (en) --> rinoceronte de java (es)
javanese (en) --> javanés (es)
jellyfish (en) --> Medusa (es)
jerboa (en) --> gerbo (es)
jewel beetle (en) --> escarabajo joya (es)
jonah crab (en) --> cangrejo jonás (es)
joro spider (en) --> araña joro (es)
jumping spider (en) --> araña saltadora (es)
jungle carpet python (en) --> pitón alfombra de la selva (es)
junglefowl (en) --> aves de la jungla (es)
kai ken (en) --> kai ken (es)
kakapo (en) --> kakapo (es)
kangal (en) --> kangal (es)
kangaroo (en) --> canguro (es)
kangaroo rat (en) --> Rata canguro (es)
keel-billed toucan (en) --> tucán pico de quilla (es)
keelback (en) --> quilla (es)
keeshond (en) --> keeshond (es)
kenyan sand boa (en) --> boa de arena de Kenia (es)
kerry blue terrier (en) --> terrier azul de kerry (es)
kestrel (en) --> cernícalo (es)
keta salmon (en) --> salmón keta (es)
key deer (en) --> ciervo clave (es)
kiko goat (en) --> cabra kiko (es)
killdeer (en) --> asesino (es)
killer whale (en) --> Orca (es)
kinabalu giant red leech (en) --> sanguijuela roja gigante de kinabalu (es)
kinder goat (en) --> cabra más amable (es)
king cobra (en) --> cobra real (es)
king crab (en) --> cangrejo real (es)
king penguin (en) --> pingüino real (es)
king rat snake (en) --> serpiente rata rey (es)
king shepherd (en) --> rey pastor (es)
king snake (en) --> Rey Serpiente (es)
king vulture (en) --> buitre rey (es)
kingfisher (en) --> martín pescador (es)
kinkajou (en) --> kinkajú (es)
kirtland’s snake (en) --> la serpiente de kirtland (es)
kishu (en) --> kishu (es)
kit fox (en) --> kit de zorro (es)
kitefin shark (en) --> tiburón cometa (es)
kiwi (en) --> kiwi (es)
klipspringer (en) --> klipspringer (es)
koala (en) --> coala (es)
kodkod (en) --> kodkod (es)
koi fish (en) --> pez koi (es)
komodo dragon (en) --> Dragon de Komodo (es)
kooikerhondje (en) --> kooikerhondje (es)
kookaburra (en) --> cucaburra (es)
koolie (en) --> koolie (es)
kori bustard (en) --> avutarda kori (es)
krait (en) --> krait (es)
krill (en) --> kril (es)
kudu (en) --> kudú (es)
kuvasz (en) --> kuvasz (es)
labahoula (en) --> labahoula (es)
labmaraner (en) --> laboratoriomaraner (es)
labradane (en) --> labradane (es)
labradoodle (en) --> labradoodle (es)
labrador retriever (en) --> Labrador retriever (es)
labraheeler (en) --> labraheeler (es)
ladybug (en) --> mariquita (es)
lake sturgeon (en) --> esturión de lago (es)
lakeland terrier (en) --> terrier del lago (es)
lamancha goat (en) --> cabra lamancha (es)
lamprey (en) --> lamprea (es)
lancashire heeler (en) --> talón de lancashire (es)
lappet-faced vulture (en) --> buitre orejudo (es)
lapponian herder (en) --> pastor lapón (es)
lawnmower blenny (en) --> blenio cortacésped (es)
lazarus lizard (en) --> lagarto lázaro (es)
leaf-tailed gecko (en) --> geco de cola de hoja (es)
leatherback sea turtle (en) --> tortuga laúd (es)
leech (en) --> sanguijuela (es)
lemming (en) --> leming (es)
lemur (en) --> lémur (es)
leonberger (en) --> Leonberger (es)
leopard (en) --> leopardo (es)
leopard cat (en) --> gato leopardo (es)
leopard frog (en) --> rana leopardo (es)
leopard gecko (en) --> geco leopardo (es)
leopard lizard (en) --> lagarto leopardo (es)
leopard seal (en) --> foca leopardo (es)
leopard shark (en) --> tiburón leopardo (es)
leopard tortoise (en) --> tortuga leopardo (es)
lhasa apso (en) --> lhasa apso (es)
lhasapoo (en) --> lhasapoo (es)
liger (en) --> ligre (es)
lion (en) --> león (es)
lion’s mane jellyfish (en) --> medusa melena de león (es)
lionfish (en) --> pez león (es)
little brown bat (en) --> pequeño murciélago marrón (es)
little penguin (en) --> pequeño pinguino (es)
livyatan (en) --> liviatán (es)
lizard (en) --> lagarto (es)
lizardfish (en) --> pez lagarto (es)
llama (en) --> llama (es)
loach (en) --> locha (es)
lobster (en) --> langosta (es)
locust (en) --> langosta (es)
lone star tick (en) --> garrapata estrella solitaria (es)
long-eared owl (en) --> búho chico (es)
long-haired rottweiler (en) --> rottweiler de pelo largo (es)
long-tailed tit (en) --> teta de cola larga (es)
longfin mako shark (en) --> tiburón mako de aleta larga (es)
longnose gar (en) --> pez de nariz larga (es)
lorikeet (en) --> lorito (es)
lowchen (en) --> bajo (es)
lumpfish (en) --> lumpo (es)
lungfish (en) --> pez pulmonado (es)
lynx (en) --> lince (es)
lyrebird (en) --> ave lira (es)
macaque (en) --> macaco (es)
macaroni penguin (en) --> pinguino macarrones (es)
macaw (en) --> guacamayo (es)
mackenzie wolf (en) --> lobo mackenzie (es)
madagascar hissing cockroach (en) --> cucaracha silbante de madagascar (es)
madagascar tree boa (en) --> boa del árbol de madagascar (es)
magellanic penguin (en) --> pinguino de magallanes (es)
maggot (en) --> gusano (es)
magpie (en) --> urraca (es)
mahi mahi (en) --> Mahi mahi (es)
dolphin fish (en) --> pez delfín (es)
maiasaura (en) --> maiasaura (es)
maine coon (en) --> maine coon (es)
malayan civet (en) --> civeta malaya (es)
malayan krait (en) --> krait malayo (es)
malayan tiger (en) --> tigre malayo (es)
malchi (en) --> Malchi (es)
mallard (en) --> pato real (es)
malteagle (en) --> malteagle (es)
maltese (en) --> maltés (es)
maltese shih tzu (en) --> shih tzu maltés (es)
maltipoo (en) --> maltipoo (es)
mamba (en) --> tipo de serpiente venenosa (es)
mamushi snake (en) --> serpiente mamushi (es)
man of war jellyfish (en) --> medusa hombre de guerra (es)
manatee (en) --> manatí (es)
manchester terrier (en) --> terrier de manchester (es)
mandarin rat snake (en) --> serpiente rata mandarina (es)
mandrill (en) --> mandril (es)
maned wolf (en) --> Lobo amelenado (es)
mangrove snake (en) --> serpiente de manglar (es)
manta ray (en) --> Manta raya (es)
mantella frog (en) --> rana mantella (es)
marabou stork (en) --> cigüeña marabú (es)
marble fox (en) --> zorro de mármol (es)
marine iguana (en) --> Iguana marina (es)
marine toad (en) --> sapo marino (es)
markhor (en) --> marjor (es)
marmoset (en) --> tití (es)
marmot (en) --> marmota (es)
marsh frog (en) --> rana de pantano (es)
masked angelfish (en) --> pez ángel enmascarado (es)
masked palm civet (en) --> civeta de palma enmascarada (es)
massasauga (en) --> massasauga (es)
mastador (en) --> mastador (es)
mastiff (en) --> mastín (es)
mayfly (en) --> efímera (es)
meagle (en) --> meagle (es)
mealybug (en) --> cochinilla (es)
meerkat (en) --> suricata (es)
megalania (en) --> Megalania (es)
megalodon (en) --> megalodón (es)
megamouth shark (en) --> tiburón boca ancha (es)
megatherium (en) --> megaterio (es)
mekong giant catfish (en) --> bagre gigante del mekong (es)
mexican alligator lizard (en) --> lagarto cocodrilo mexicano (es)
mexican black kingsnake (en) --> serpiente rey negra mexicana (es)
mexican eagle (en) --> águila mexicana (es)
northern crested caracara (en) --> caracara de cresta norte (es)
mexican free-tailed bat (en) --> murciélago mexicano de cola libre (es)
mexican mole lizard (en) --> lagarto topo mexicano (es)
microraptor (en) --> microraptor (es)
midget faded rattlesnake (en) --> serpiente de cascabel descolorida enana (es)
miki (en) --> miki (es)
milk snake (en) --> serpiente de leche (es)
milkfish (en) --> sabalote (es)
millipede (en) --> milpiés (es)
mini labradoodle (en) --> mini labradoodle (es)
miniature bull terrier (en) --> bull terrier miniatura (es)
miniature husky (en) --> husky miniatura (es)
miniature pinscher (en) --> pinscher miniatura (es)
mink (en) --> visón (es)
minke whale (en) --> ballena minke (es)
mississippi kite (en) --> cometa misisipí (es)
moccasin snake (en) --> serpiente mocasín (es)
mojarra (en) --> mojarra (es)
mojave rattlesnake (en) --> serpiente de cascabel de mojave (es)
mola mola (en) --> mola mola (es)
ocean sunfish (en) --> pez luna del océano (es)
mole (en) --> Topo (es)
mole cricket (en) --> grillo topo (es)
mole snake (en) --> serpiente topo (es)
molly (en) --> muchacha (es)
monarch butterfly (en) --> mariposa monarca (es)
mongoose (en) --> mangosta (es)
mongrel (en) --> mestizo (es)
monitor lizard (en) --> lagarto monitor (es)
monkey (en) --> mono (es)
monkfish (en) --> rape (es)
monocled cobra (en) --> cobra monóculo (es)
monte iberia eleuth (en) --> monte iberia eleuth (es)
moon jellyfish (en) --> medusa luna (es)
moorhen (en) --> polla de agua (es)
moose (en) --> alce (es)
moray eel (en) --> morena (es)
morkie (en) --> morkie (es)
mosasaurus (en) --> mosasaurio (es)
moscow watchdog (en) --> perro guardián de moscú (es)
mosquito (en) --> mosquito (es)
moth (en) --> polilla (es)
mountain bluebird (en) --> pájaro azul de la montaña (es)
mountain cur (en) --> perro de montaña (es)
mountain feist (en) --> pelea de montaña (es)
mountain gorilla (en) --> gorila de montaña (es)
mountain lion (en) --> León de montaña (es)
mourning dove (en) --> Paloma de luto (es)
mouse (en) --> ratón (es)
mozambique spitting cobra (en) --> mozambique cobra escupidora (es)
mud snake (en) --> serpiente de barro (es)
mudi (en) --> Mudi (es)
mudpuppy (en) --> cachorro de barro (es)
mule (en) --> mula (es)
mulga snake (en) --> serpiente mulga (es)
muntjac (en) --> muntjac (es)
muskox (en) --> buey almizclero (es)
muskrat (en) --> rata almizclera (es)
mussurana snake (en) --> serpiente mussurana (es)
muttaburrasaurus (en) --> Muttaburrasaurio (es)
myna bird (en) --> pájaro myna (es)
naked mole rat (en) --> rata topo desnuda (es)
narwhal (en) --> narval (es)
natterjack (en) --> charlatán (es)
neanderthal (en) --> neanderthal (es)
neapolitan mastiff (en) --> mastín napolitano (es)
nebelung (en) --> nebelung (es)
needlefish (en) --> aguja (es)
neon tetra (en) --> tetra neón (es)
neptune grouper (en) --> mero neptuno (es)
newfoundland (en) --> Terranova (es)
newfypoo (en) --> nuevofypoo (es)
newt (en) --> tritón (es)
nicobar pigeon (en) --> paloma nicobar (es)
nigerian goat (en) --> cabra nigeriana (es)
night adder (en) --> víbora nocturna (es)
night heron (en) --> garza nocturna (es)
night snake (en) --> serpiente nocturna (es)
nightingale (en) --> ruiseñor (es)
nile crocodile (en) --> cocodrilo del Nilo (es)
nilgai (en) --> nilgai (es)
no see ums (en) --> no nos vemos (es)
norfolk terrier (en) --> terrier norfolk (es)
north american black bear (en) --> oso negro norteamericano (es)
northern alligator lizard (en) --> lagarto caimán del norte (es)
northern cardinal (en) --> cardenal del norte (es)
northern fur seal (en) --> lobo marino del norte (es)
northern inuit dog (en) --> perro inuit del norte (es)
northern water snake (en) --> serpiente de agua del norte (es)
norwegian buhund (en) --> buhund noruego (es)
norwegian elkhound (en) --> sabueso noruego (es)
norwegian forest (en) --> bosque noruego (es)
norwegian lundehund (en) --> lundehund noruego (es)
norwich terrier (en) --> terrier de norwich (es)
nose-horned viper (en) --> víbora cornuda (es)
nova scotia duck tolling retriever (en) --> perro perdiguero de peaje del pato de nueva escocia (es)
nubian goat (en) --> cabra nubia (es)
nudibranch (en) --> nudibranquio (es)
numbat (en) --> adormecido (es)
nurse shark (en) --> tiburón nodriza (es)
nyala (en) --> nyala (es)
oak toad (en) --> sapo de roble (es)
oceanic whitetip shark (en) --> tiburón oceánico de puntas blancas (es)
ocelot (en) --> ocelote (es)
octopus (en) --> pulpo (es)
oenpelli python (en) --> pitón oenpelli (es)
okapi (en) --> okapi (es)
old english sheepdog (en) --> viejo pastor ingles (es)
olive baboon (en) --> babuino de oliva (es)
olive sea snake (en) --> serpiente de mar verde oliva (es)
olm (en) --> Olmo (es)
opossum (en) --> zarigüeya (es)
orang-utan (en) --> orangután (es)
orange-crowned warbler (en) --> curruca corona naranja (es)
orb weaver (en) --> tejedor de orbes (es)
ornithomimus (en) --> ornitomimo (es)
ortolan bunting (en) --> banderines ortolanos (es)
oscar fish (en) --> pez oscar (es)
ostrich (en) --> avestruz (es)
otter (en) --> nutria (es)
otterhound (en) --> sabueso (es)
oviraptor (en) --> oviraptor (es)
owl (en) --> búho (es)
ox (en) --> buey (es)
oyster (en) --> ostra (es)
oyster toadfish (en) --> pez sapo ostra (es)
pacific sleeper shark (en) --> tiburón durmiente del pacífico (es)
paddlefish (en) --> pez espátula (es)
pademelon (en) --> pademelon (es)
painted turtle (en) --> tortuga pintada (es)
pangolin (en) --> pangolín (es)
panther (en) --> pantera (es)
papillon (en) --> papillón (es)
paradise flying snake (en) --> serpiente voladora del paraíso (es)
parakeet (en) --> perico (es)
parasaurolophus (en) --> parasaurolophus (es)
parrot (en) --> loro (es)
parrot snake (en) --> serpiente loro (es)
parrotfish (en) --> pez loro (es)
parrotlet (en) --> loro (es)
parson russell terrier (en) --> párroco russell terrier (es)
patagotitan (en) --> patagotitan (es)
patas monkey (en) --> mono patas (es)
patterdale terrier (en) --> terrier patterdale (es)
pea puffer (en) --> globo de guisantes (es)
peacock (en) --> pavo real (es)
peacock butterfly (en) --> mariposa pavo real (es)
peacock spider (en) --> araña pavo real (es)
peagle (en) --> peagle (es)
peekapoo (en) --> cucú (es)
pekingese (en) --> pekinés (es)
pelican (en) --> pelícano (es)
pembroke welsh corgi (en) --> corgi gales de pembroke (es)
penguin (en) --> pingüino (es)
pennsylvania wood cockroach (en) --> Cucaracha de madera de Pensilvania (es)
peppered moth (en) --> polilla moteada (es)
peppermint angelfish (en) --> pez ángel de menta (es)
pere davids deer (en) --> el ciervo de pere david (es)
peregrine falcon (en) --> Halcón peregrino (es)
peringuey’s adder (en) --> sumador de peringuey (es)
perro de presa canario (en) --> perro de presa canario (es)
persian (en) --> persa (es)
peruvian inca orchid (en) --> orquidea inca peruana (es)
pesquet’s parrot (en) --> loro de peset (es)
dracula parrot (en) --> loro drácula (es)
petit basset griffon vendéen (en) --> petit basset leonado vendeano (es)
petite goldendoodle (en) --> pequeño garabato dorado (es)
pheasant (en) --> Faisán (es)
philippine cobra (en) --> cobra filipina (es)
phorusrhacos (en) --> forusrhacos (es)
pied ball python (en) --> pitón bola de varios colores (es)
pied tamarin (en) --> tití de varios colores (es)
pig (en) --> cerdo (es)
pigeon (en) --> paloma (es)
pika (en) --> pika (es)
pike fish (en) --> pez lucio (es)
pileated woodpecker (en) --> pájaro carpintero (es)
pine marten (en) --> marta (es)
pine snake (en) --> serpiente de pino (es)
pine snake (en) --> serpiente de pino (es)
pink fairy armadillo (en) --> armadillo hada rosa (es)
pipe snake (en) --> serpiente pipa (es)
pipefish (en) --> aguja (es)
piranha (en) --> piraña (es)
pit bull (en) --> pitbull (es)
pit viper (en) --> crótalo (es)
pitador (en) --> pitador (es)
pitsky (en) --> pitsky (es)
plains hognose snake (en) --> serpiente nariz de cerdo de las llanuras (es)
platinum arowana (en) --> platino arowana (es)
platybelodon (en) --> ornitorrinco (es)
platypus (en) --> ornitorrinco (es)
pocket beagle (en) --> beagle de bolsillo (es)
pocket pitbull (en) --> pitbull de bolsillo (es)
pointer (en) --> puntero (es)
poison dart frog (en) --> rana dardo venenoso (es)
polar bear (en) --> oso polar (es)
polecat (en) --> turón (es)
polish lowland sheepdog (en) --> perro pastor polaco de las tierras bajas (es)
polka dot stingray (en) --> mantarraya de lunares (es)
polyphemus moth (en) --> polilla polifemo (es)
pomapoo (en) --> pomapoo (es)
pomchi (en) --> pomchi (es)
pomeagle (en) --> pomeagle (es)
pomeranian (en) --> pomeranio (es)
pomsky (en) --> pomsky (es)
pond skater (en) --> patinador de estanque (es)
poochon (en) --> chucho (es)
poodle (en) --> caniche (es)
poogle (en) --> poogle (es)
pool frog (en) --> rana de la piscina (es)
porbeagle shark (en) --> tiburón cailón (es)
porcupine (en) --> puerco espín (es)
porpoise (en) --> marsopa (es)
possum (en) --> zarigüeya (es)
potoo (en) --> potoo (es)
potoroo (en) --> potoroo (es)
prairie dog (en) --> Perrito de las praderas (es)
prairie rattlesnake (en) --> serpiente de cascabel de la pradera (es)
prawn (en) --> gamba (es)
praying mantis (en) --> Mantis religiosa (es)
proboscis monkey (en) --> mono narigudo (es)
procoptodon (en) --> procoptodón (es)
pronghorn (en) --> berrendo (es)
psittacosaurus (en) --> psitacosauro (es)
pteranodon (en) --> pteranodón (es)
pterodactyl (en) --> pterodáctilo (es)
pudelpointer (en) --> pudelpointer (es)
puff adder (en) --> llamado de vibora (es)
pufferfish (en) --> pez globo (es)
puffin (en) --> frailecillo (es)
pug (en) --> doguillo (es)
pugapoo (en) --> pugapoo (es)
puggle (en) --> Puggle (es)
pugshire (en) --> pugshire (es)
puma (en) --> puma (es)
pumi (en) --> pumi (es)
purple emperor butterfly (en) --> mariposa emperador púrpura (es)
purple finch (en) --> pinzón morado (es)
puss moth (en) --> polilla (es)
pygmy hippopotamus (en) --> hipopótamo pigmeo (es)
pygmy marmoset (en) --> tití pigmeo (es)
finger monkey (en) --> mono de dedo (es)
pygmy python (en) --> pitón pigmea (es)
pygmy shark (en) --> tiburon pigmeo (es)
pygora goat (en) --> cabra pigora (es)
pyjama shark (en) --> tiburón pijama (es)
pyrador (en) --> pirador (es)
pyredoodle (en) --> pirograbado (es)
python (en) --> pitón (es)
quagga (en) --> cuagga (es)
quail (en) --> codorniz (es)
queen snake (en) --> serpiente reina (es)
quetzal (en) --> quetzal (es)
quokka (en) --> quokka (es)
quoll (en) --> quoll (es)
rabbit (en) --> Conejo (es)
raccoon (en) --> mapache (es)
raccoon dog (en) --> perro mapache (es)
racer snake (en) --> serpiente corredora (es)
radiated tortoise (en) --> tortuga radiada (es)
ragamuffin (en) --> granuja (es)
ragdoll (en) --> muñeca de trapo (es)
raggle (en) --> harapiento (es)
rainbow boa (en) --> boa arcoiris (es)
rainbow shark (en) --> tiburon arcoiris (es)
rat (en) --> rata (es)
rat snakes (en) --> serpientes de rata (es)
rat terrier (en) --> terrier de rata (es)
rattlesnake (en) --> serpiente de cascabel (es)
red diamondback rattlesnake (en) --> serpiente de cascabel de espalda de diamante rojo (es)
red finch (en) --> pinzón rojo (es)
red fox (en) --> zorro rojo (es)
red kite (en) --> cometa roja (es)
red knee tarantula (en) --> tarántula de rodilla roja (es)
red panda (en) --> Panda rojo (es)
red racer snake (en) --> serpiente corredora roja (es)
red spitting cobra (en) --> cobra escupidora roja (es)
red squirrel (en) --> Ardilla roja (es)
red tail boa (en) --> boa de cola roja (es)
common boa (en) --> boa común (es)
red wolf (en) --> Lobo rojo (es)
red-bellied black snake (en) --> serpiente negra de vientre rojo (es)
red-billed quelea bird (en) --> ave quelea de pico rojo (es)
red-eared slider (en) --> deslizador de orejas rojas (es)
red-eyed tree frog (en) --> rana arborícola de ojos rojos (es)
red-footed tortoise (en) --> tortuga de patas rojas (es)
red-handed tamarin (en) --> tití manos rojas (es)
red-headed vulture (en) --> buitre de cabeza roja (es)
red-lipped batfish (en) --> pez murciélago de labios rojos (es)
red-winged blackbird (en) --> mirlo de alas rojas (es)
redback spider (en) --> araña de espalda roja (es)
redbone coonhound (en) --> Coonhound de hueso rojo (es)
redtail catfish (en) --> bagre de cola roja (es)
reef shark (en) --> tiburón de arrecife (es)
reindeer (en) --> reno (es)
repenomamus (en) --> repenomamus (es)
reticulated python (en) --> pitón reticulada (es)
rhino viper (en) --> víbora rinoceronte (es)
rhinoceros (en) --> rinoceronte (es)
rhombic egg-eater snake (en) --> serpiente comedora de huevos rómbica (es)
ribbon eel (en) --> anguila de cinta (es)
ribbon snake (en) --> serpiente de cinta (es)
ring-billed gull (en) --> gaviota de pico anillado (es)
ringed kingfisher (en) --> martín pescador anillado (es)
rinkhals snake (en) --> serpiente rinkhals (es)
river otter (en) --> nutria de río (es)
river turtle (en) --> tortuga de rio (es)
robin (en) --> Robin (es)
rock crab (en) --> cangrejo de roca (es)
rock hyrax (en) --> hyrax de roca (es)
rock python (en) --> pitón de roca (es)
rockfish (en) --> pescado de roca (es)
rockhopper penguin (en) --> pingüino penacho amarillo (es)
rodents (en) --> roedores (es)
roe deer (en) --> Corzo (es)
rooster (en) --> gallo (es)
rose-breasted grosbeak (en) --> picogrueso de pecho rosa (es)
roseate spoonbill (en) --> espátula rosada (es)
rosy boa (en) --> boa rosada (es)
rottsky (en) --> Rottsky (es)
rottweiler (en) --> rottweiler (es)
rough green snake (en) --> serpiente verde áspera (es)
royal penguin (en) --> pinguino real (es)
rubber boa (en) --> boa de goma (es)
ruby-throated hummingbird (en) --> colibrí garganta de rubí (es)
ruddy turnstone (en) --> Vuelvepiedras rojizo (es)
russel’s viper (en) --> víbora de russell (es)
russell terrier (en) --> terrier russell (es)
russian bear dog (en) --> perro oso ruso (es)
russian blue (en) --> azul ruso (es)
russian tortoise (en) --> tortuga rusa (es)
saanen goat (en) --> cabra saanen (es)
saarloos wolfdog (en) --> perro lobo de saarloos (es)
saber-toothed tiger (en) --> Tigre dientes de sable (es)
sable (en) --> sable (es)
sable black german shepherd (en) --> pastor aleman negro sable (es)
sable ferret (en) --> hurón sable (es)
saiga (en) --> Saiga (es)
saint berdoodle (en) --> san berdoodle (es)
saint bernard (en) --> San Bernardo (es)
saint shepherd (en) --> santo pastor (es)
salamander (en) --> salamandra (es)
salmon (en) --> salmón (es)
salmon shark (en) --> tiburón salmón (es)
saluki (en) --> Saluki (es)
sambar (en) --> sambar (es)
samoyed (en) --> samoyedo (es)
san francisco garter snake (en) --> serpiente de liga de san francisco (es)
sand crab (en) --> cangrejo de arena (es)
sand lizard (en) --> lagarto de arena (es)
sand tiger shark (en) --> tiburón tigre de arena (es)
sand viper (en) --> víbora de arena (es)
saola (en) --> Saola (es)
sardines (en) --> sardinas (es)
satanic leaf-tailed gecko (en) --> geco satánico de cola de hoja (es)
sauropoda (en) --> sauropoda (es)
savanna goat (en) --> cabra sabana (es)
savannah sparrow (en) --> gorrión sabana (es)
saw-scaled viper (en) --> víbora de escamas de sierra (es)
sawfish (en) --> pez sierra (es)
scarlet kingsnake (en) --> serpiente rey escarlata (es)
scarlet macaw (en) --> guacamaya roja (es)
schipperke (en) --> salteado (es)
schneagle (en) --> Schneagle (es)
schnoodle (en) --> schnoodle (es)
scimitar-horned oryx (en) --> órix de cuernos de cimitarra (es)
scorpion (en) --> escorpión (es)
scorpion fish (en) --> pez escorpión (es)
scottish terrier (en) --> terrier escocés (es)
scrotum frog (en) --> rana escroto (es)
sculpin (en) --> esculpir (es)
sea anemone (en) --> anémona de mar (es)
sea dragon (en) --> dragón marino (es)
sea eagle (en) --> Águila marina (es)
sea lion (en) --> León marino (es)
sea otter (en) --> nutria de mar (es)
sea roach (en) --> cucaracha de mar (es)
sea slug (en) --> babosa de mar (es)
sea squirt (en) --> ascidia (es)
sea turtle (en) --> tortuga marina (es)
sea urchin (en) --> erizo de mar (es)
seagull (en) --> Gaviota (es)
seahorse (en) --> caballo de mar (es)
seal (en) --> sello (es)
sealyham terrier (en) --> terrier sealyham (es)
sei whale (en) --> ballena sei (es)
senegal parrot (en) --> loro senegalés (es)
serval (en) --> gato cerval (es)
shark (en) --> tiburón (es)
sharp-tailed snake (en) --> serpiente de cola afilada (es)
sheep (en) --> oveja (es)
sheepadoodle (en) --> garabato de ovejas (es)
shepadoodle (en) --> garabato (es)
shepkita (en) --> shepkita (es)
shepweiler (en) --> shepweiler (es)
shiba inu (en) --> Shiba Inu (es)
shih poo (en) --> mierda caca (es)
shih tzu (en) --> shih-tzu (es)
shoebill stork (en) --> cigüeña picozapato (es)
shollie (en) --> shollie (es)
short-faced bear (en) --> oso de cara corta (es)
shortfin mako shark (en) --> tiburón marrajo dientuso (es)
shrew (en) --> musaraña (es)
shrimp (en) --> camarón (es)
siamese (en) --> siamés (es)
siberian (en) --> siberiano (es)
siberian husky (en) --> Husky siberiano (es)
siberian ibex (en) --> cabra montés siberiano (es)
siberian retriever (en) --> perro perdiguero siberiano (es)
siberian tiger (en) --> Tigre siberiano (es)
siberpoo (en) --> siberpoo (es)
sidewinder (en) --> sidewinder (es)
silkie chicken (en) --> pollo sedoso (es)
silky shark (en) --> tiburon sedoso (es)
silky terrier (en) --> terrier sedoso (es)
silver dollar (en) --> dólar de plata (es)
silver labrador (en) --> labrador plateado (es)
sinosauropteryx (en) --> sinosauropteryx (es)
sixgill shark (en) --> tiburón de seis branquias (es)
skate fish (en) --> pez raya (es)
skink lizard (en) --> lagarto eslizón (es)
skipjack tuna (en) --> atún listado (es)
skunk (en) --> zorrillo (es)
skye terrier (en) --> skye-terrier (es)
sleeper shark (en) --> tiburón durmiente (es)
sloth (en) --> ranura (es)
slow worm (en) --> gusano lento (es)
slug (en) --> babosa (es)
smokybrown cockroach (en) --> cucaracha ahumada (es)
smooth fox terrier (en) --> fox terrier liso (es)
smooth green snake (en) --> serpiente verde suave (es)
smooth snake (en) --> serpiente lisa (es)
snail (en) --> caracol (es)
snake (en) --> serpiente (es)
snapping turtle (en) --> tortuga mordedora (es)
snook fish (en) --> pez róbalo (es)
snorkie (en) --> snorkie (es)
snouted cobra (en) --> cobra de hocico (es)
snow crab (en) --> cangrejo de las nieves (es)
snow leopard (en) --> leopardo de nieve (es)
snowshoe (en) --> raqueta de nieve (es)
snowshoe hare (en) --> liebre de patas blancas (es)
snowy owl (en) --> buho Nevado (es)
sockeye salmon (en) --> salmón rojo (es)
somali (en) --> somalí (es)
song sparrow (en) --> gorrión cantor (es)
song thrush (en) --> tordo cantor (es)
south china tiger (en) --> tigre del sur de china (es)
southern black racer (en) --> corredor negro del sur (es)
southern hognose snake (en) --> serpiente nariz de cerdo del sur (es)
southern pacific rattlesnake (en) --> serpiente de cascabel del pacífico sur (es)
spadefoot toad (en) --> sapo de espuelas (es)
spanador (en) --> español (es)
spanish goat (en) --> cabra española (es)
spanish mastiff (en) --> mastín español (es)
sparrow (en) --> gorrión (es)
sparrowhawk (en) --> gavilán (es)
speckled kingsnake (en) --> serpiente rey moteada (es)
spectacled bear (en) --> oso con gafas (es)
sperm whale (en) --> cachalote (es)
spider (en) --> araña (es)
spider ball python (en) --> pitón bola de araña (es)
spider monkey (en) --> mono araña (es)
spider wasp (en) --> avispa araña (es)
spider-tailed horned viper (en) --> víbora cornuda de cola de araña (es)
spinner shark (en) --> tiburón giratorio (es)
spinone italiano (en) --> spinone italiano (es)
spinosaurus (en) --> espinosaurio (es)
spiny dogfish (en) --> mielga (es)
spiny hill turtle (en) --> tortuga de montaña espinosa (es)
spitting cobra (en) --> cobra escupidora (es)
spixs macaw (en) --> guacamayo de spix (es)
sponge (en) --> esponja (es)
spotted gar (en) --> gar manchado (es)
spotted lanternfly (en) --> mosca linterna manchada (es)
spotted python (en) --> pitón manchado (es)
springador (en) --> saltador (es)
springbok (en) --> gacela (es)
springerdoodle (en) --> saltador (es)
squash beetle (en) --> escarabajo de calabaza (es)
squid (en) --> calamar (es)
squirrel (en) --> ardilla (es)
squirrel monkey (en) --> mono ardilla (es)
squirrelfish (en) --> pez ardilla (es)
sri lankan elephant (en) --> elefante de Sri Lanka (es)
stabyhoun (en) --> stabyhoun (es)
staffordshire bull terrier (en) --> Staffordshire Bull Terrier (es)
stag beetle (en) --> escarabajo ciervo (es)
standard schnauzer (en) --> schnauzer estándar (es)
star-nosed mole (en) --> Topo de nariz estrella (es)
starfish (en) --> estrella de mar (es)
stargazer fish (en) --> pez astrónomo (es)
steelhead salmon (en) --> salmón trucha arco iris (es)
steller’s sea cow (en) --> vaca marina de steller (es)
stick insect (en) --> insecto palo (es)
stiletto snake (en) --> serpiente estilete (es)
stingray (en) --> mantarraya (es)
stoat (en) --> armiño (es)
stone crab (en) --> cangrejo de piedra (es)
stork (en) --> cigüeña (es)
striped hyena (en) --> hiena rayada (es)
striped rocket frog (en) --> rana cohete rayada (es)
sturgeon (en) --> esturión (es)
styracosaurus (en) --> tiracosaurio (es)
suchomimus (en) --> talomimus (es)
sucker fish (en) --> pez lechón (es)
sugar glider (en) --> planeador del azúcar (es)
sulcata tortoise (en) --> tortuga sulcata (es)
sumatran elephant (en) --> elefante de sumatra (es)
sumatran orang-utan (en) --> orangután de sumatra (es)
sumatran rhinoceros (en) --> rinoceronte de sumatra (es)
sumatran tiger (en) --> tigre de sumatra (es)
sun bear (en) --> oso del sol (es)
sunbeam snake (en) --> serpiente rayo de sol (es)
surgeonfish (en) --> pez cirujano (es)
swai fish (en) --> peces swai (es)
swan (en) --> cisne (es)
swedish vallhund (en) --> vallhund sueco (es)
syrian hamster (en) --> hámster sirio (es)
taco terrier (en) --> taco terrier (es)
taipan (en) --> taipán (es)
takin (en) --> tomando (es)
tamaskan (en) --> tamaskan (es)
tang (en) --> Espiga (es)
tapanuli orang-utan (en) --> orangután tapanuli (es)
tapir (en) --> tapir (es)
tarantula hawk (en) --> halcón tarántula (es)
tarbosaurus (en) --> tarbosaurio (es)
tarpon (en) --> sábalo (es)
tarsier (en) --> tarsero (es)
tasmanian devil (en) --> Demonio de Tasmania (es)
tasmanian tiger (en) --> Tigre de Tasmania (es)
tawny owl (en) --> buho Carabo (es)
teddy bear hamster (en) --> oso de peluche hámster (es)
teddy roosevelt terrier (en) --> peluche roosevelt terrier (es)
telescope fish (en) --> pez telescopio (es)
tennessee walking horse (en) --> caballo que camina de tennessee (es)
tenterfield terrier (en) --> terrier de campo de tenter (es)
termite (en) --> termita (es)
terrier (en) --> terrier (es)
terror bird (en) --> pájaro del terror (es)
tetra (en) --> tetra (es)
texas blind snake (en) --> serpiente ciega de texas (es)
texas coral snake (en) --> serpiente de coral de texas (es)
texas garter snake (en) --> serpiente de liga de texas (es)
texas heeler (en) --> talonador de texas (es)
texas indigo snake (en) --> serpiente índigo de texas (es)
texas night snake (en) --> serpiente nocturna de texas (es)
texas rat snake (en) --> serpiente rata de texas (es)
texas spiny lizard (en) --> lagarto espinoso de texas (es)
thai ridgeback (en) --> cresta dorsal tailandesa (es)
thorny devil (en) --> diablo espinoso (es)
thresher shark (en) --> tiburón azotador (es)
thrush (en) --> tordo (es)
thylacoleo (en) --> tilacoleo (es)
tibetan fox (en) --> zorro tibetano (es)
tibetan mastiff (en) --> mastín tibetano (es)
tibetan spaniel (en) --> perro de aguas tibetano (es)
tibetan terrier (en) --> terrier tibetano (es)
tick (en) --> garrapata (es)
tiffany (en) --> tiffany (es)
tiger (en) --> Tigre (es)
tiger beetle (en) --> escarabajo tigre (es)
tiger moth (en) --> Piel de tigre (es)
tiger rattlesnake (en) --> serpiente de cascabel tigre (es)
tiger salamander (en) --> salamandra tigre (es)
tiger shark (en) --> tiburón tigre (es)
timber rattlesnake (en) --> serpiente de cascabel de madera (es)
canebrake rattlesnake (en) --> serpiente de cascabel del cañaveral (es)
timor python (en) --> pitón de timor (es)
tire track eel (en) --> anguila huella de neumático (es)
titanoboa (en) --> titanoboa (es)
toadfish (en) --> pez sapo (es)
torkie (en) --> torkie (es)
tortoise (en) --> tortuga (es)
toucan (en) --> tucán (es)
toy fox terrier (en) --> fox terrier de juguete (es)
toy poodle (en) --> poodle de juguete (es)
transylvanian hound (en) --> sabueso de transilvania (es)
tree frog (en) --> rana de árbol (es)
tree kangaroo (en) --> canguro de árbol (es)
tree snake (en) --> serpiente de árbol (es)
tree swallow (en) --> golondrina de arbol (es)
treecreeper (en) --> trepador de árboles (es)
treeing tennessee brindle (en) --> atigrado de tennessee (es)
treeing walker coonhound (en) --> coonhound (es)
troodon (en) --> troodón (es)
tropicbird (en) --> ave tropical (es)
trout (en) --> trucha (es)
tsetse fly (en) --> mosca tsetse (es)
tuatara (en) --> tuátara (es)
tuna (en) --> atún (es)
turkey (en) --> Turquía (es)
turkish angora (en) --> angora turca (es)
turtles (en) --> tortugas (es)
twig snake (en) --> serpiente ramita (es)
tyrannosaurus rex (en) --> tirano-saurio Rex (es)
uakari (en) --> uakarí (es)
uguisu (en) --> uguisu (es)
uinta ground squirrel (en) --> ardilla de tierra (es)
uintatherium (en) --> untaterio (es)
umbrellabird (en) --> pájaro paraguas (es)
unau (en) --> unaú (es)
linnaeus’s two-toed sloth (en) --> el perezoso de dos dedos de linneo (es)
ural owl (en) --> búho ural (es)
urutu snake (en) --> serpiente urutu (es)
utonagan (en) --> utonagan (es)
vampire bat (en) --> murciélago vampiro (es)
vampire squid (en) --> calamar vampiro (es)
vaquita (en) --> vaquita (es)
velociraptor (en) --> velociraptor (es)
venus flytrap (en) --> Venus atrapamoscas (es)
vervet monkey (en) --> mono verde (es)
vicuña (en) --> vicuña (es)
vine snake (en) --> serpiente de vid (es)
vinegaroon (en) --> Vinagre (es)
viper (en) --> víbora (es)
viper shark (en) --> tiburón víbora (es)
dogfish (en) --> cazón (es)
virgin islands dwarf gecko (en) --> gecko enano de las islas virgenes (es)
vizsla (en) --> vizsla (es)
volpino italiano (en) --> volpino italiano (es)
vulture (en) --> buitre (es)
wahoo fish (en) --> pez wahoo (es)
waimanu (en) --> waimanu (es)
walking catfish (en) --> bagre caminando (es)
wallaby (en) --> canguro (es)
walleye fish (en) --> pez leucoma (es)
walrus (en) --> morsa (es)
wandering albatross (en) --> albatros errante (es)
warthog (en) --> jabalí (es)
wasp (en) --> avispa (es)
water buffalo (en) --> búfalo de agua (es)
water dragon (en) --> Dragón de agua (es)
water vole (en) --> campañol de agua (es)
weasel (en) --> comadreja (es)
weaver bird (en) --> Tejedor de aves (es)
weimaraner (en) --> weimaraner (es)
weimardoodle (en) --> weimardoodle (es)
wels catfish (en) --> bagre wels (es)
welsh corgi (en) --> corgi galés (es)
welsh terrier (en) --> terrier galés (es)
west highland terrier (en) --> terrier de las tierras altas del oeste (es)
western blind snake (en) --> serpiente ciega occidental (es)
western diamondback rattlesnake (en) --> serpiente de cascabel de espalda de diamante occidental (es)
western gorilla (en) --> gorila occidental (es)
western green mamba (en) --> mamba verde occidental (es)
western hognose snake (en) --> serpiente nariz de cerdo occidental (es)
western lowland gorilla (en) --> gorila occidental de tierras bajas (es)
western rat snake (en) --> serpiente rata occidental (es)
westiepoo (en) --> westiepoo (es)
whale shark (en) --> tiburón ballena (es)
wheaten terrier (en) --> terrier de trigo (es)
whimbrel (en) --> zarapito trinador (es)
whinchat (en) --> trinquete (es)
whippet (en) --> lebrel (es)
whiptail lizard (en) --> lagarto cola de látigo (es)
white butterfly (en) --> mariposa blanca (es)
white ferret (en) --> hurón blanco (es)
albino ferrets (en) --> hurones albinos (es)
white rhinoceros (en) --> rinoceronte blanco (es)
white shark (en) --> tiburón blanco (es)
white tiger (en) --> Tigre blanco (es)
white-faced capuchin (en) --> capuchino de cara blanca (es)
white-tail deer (en) --> ciervo de cola blanca (es)
white-tailed eagle (en) --> águila de cola blanca (es)
whiting (en) --> pescadilla (es)
whoodle (en) --> gritar (es)
whooping crane (en) --> grulla blanca (es)
wild boar (en) --> Jabalí (es)
wildebeest (en) --> ñu (es)
willow warbler (en) --> curruca de sauce (es)
wire fox terrier (en) --> fox terrier de alambre (es)
wirehaired pointing griffon (en) --> Grifón señalador de pelo duro (es)
wolf (en) --> lobo (es)
wolf eel (en) --> anguila lobo (es)
wolf snake (en) --> serpiente lobo (es)
wolf spider (en) --> araña lobo (es)
wolffish (en) --> pez lobo (es)
wolverine (en) --> glotón (es)
woma python (en) --> mujer pitón (es)
wombat (en) --> uómbat (es)
wood bison (en) --> bisonte de madera (es)
wood frog (en) --> rana de madera (es)
wood tick (en) --> garrapata de madera (es)
wood turtle (en) --> tortuga de madera (es)
woodlouse (en) --> cochinilla (es)
woodlouse spider (en) --> araña cochinilla (es)
woodpecker (en) --> pájaro carpintero (es)
woodrat (en) --> rata de bosque (es)
woolly mammoth (en) --> Mamut lanudo (es)
woolly monkey (en) --> mono lanudo (es)
woolly rhinoceros (en) --> rinoceronte lanudo (es)
worm (en) --> gusano (es)
worm snake (en) --> serpiente gusano (es)
wrasse (en) --> napoleón (es)
writing spider (en) --> araña de escritura (es)
wrought iron butterflyfish (en) --> pez mariposa de hierro forjado (es)
wyoming toad (en) --> sapo de wyoming (es)
x-ray tetra (en) --> tetra de rayos x (es)
xerus (en) --> xerus (es)
xoloitzcuintli (en) --> xoloitzcuintli (es)
yak (en) --> yak (es)
yakutian laika (en) --> laika yakutiana (es)
yarara (en) --> yarara (es)
yellow anaconda (en) --> anaconda amarilla (es)
yellow cobra (en) --> cobra amarilla (es)
yellow sac spider (en) --> araña de saco amarillo (es)
yellow spotted lizard (en) --> lagarto manchado amarillo (es)
yellow-bellied sea snake (en) --> serpiente marina de vientre amarillo (es)
yellow-eyed penguin (en) --> pingüino de ojos amarillos (es)
yellowfin tuna (en) --> atún de aleta amarilla (es)
yeti crab (en) --> cangrejo yeti (es)
yoranian (en) --> yoranian (es)
yorkie bichon (en) --> bichón yorkie (es)
yorkie-poo (en) --> yorkie-poo (es)
yorkshire terrier (en) --> terrier de yorkshire (es)
zebra (en) --> cebra (es)
zebra finch (en) --> pinzón cebra (es)
zebra mussels (en) --> mejillones cebra (es)
zebra pleco (en) --> pleco cebra (es)
zebra shark (en) --> tiburon cebra (es)
zebra snake (en) --> serpiente cebra (es)
zebra spitting cobra (en) --> cobra escupidora de cebra (es)
zebu (en) --> cebú (es)
zonkey (en) --> zonkey (es)
zorse (en) --> zorro (es)
zuchon (en) --> zuchon (es)
serpent (en) --> serpiente (es)
black widow (en) --> viuda negra (es)
antilope (en) --> antílope (es)
bass (en) --> bajo (es)
manturon (en) --> manturón (es)
himalayan bear (en) --> oso del himalaya (es)
orangutan (en) --> orangután (es)
sea snake (en) --> serpiente de mar (es)
condor (en) --> cóndor (es)
panda (en) --> panda (es)
cacatua (en) --> cacatúa (es)
dragon (en) --> continuar (es)
hydra (en) --> hidra (es)